8 9
0 1 5 1 0 5 0 0
5 0 0 4 1 0 1 5
0 1 1 5 4 4 0 1
4 4 1 0 1 0 4 0
0 5 1 1 0 4 3 4
1 5 1 1 4 2 7 4
1 2 5 5 1 6 5 0
1 6 0 4 4 0 2 0
4 4 5 5 1 1 6 5